...........................
...........................
...........................
...........................
...........................
...........................
...........................
...........................
...........................
...........................
...........................
*****************..........
***************************
