...........................
...........................
...........................
...........................
...........................
...........................
...........................
...........................
...........................
...........................
..**.......................
*****************..........
***************************
