...........................
..........e................
...........................
...........................
...........................
.......*....*...***........
.......******........*.....
.....................******
...................*.......
...c......*********........
..***********ffff..........
*****************..........
***************************
